+++++++++++++++++++++++++++
+     ++ ++ +             +
         +     ++++++++++++
+  +    +  ++++  +++ +++ ++
+  +   +   ++ +  +++  +++++
++++++++   +  +    ++ ++ ++
++++++++   ++++  + +   ++++
+                + +S +++++
+++++ ++ ++  ++   +++ ++  +
+++++++++++++++++++++++++++